176 176 176 176 176 176 176 176 176 176 176 176 176 176 176 176 176 176 176 176
176 255 176 255 255 255 255 255 255 255 255 255 255 176 255 255 255 255 255 176
176 255	176 176 176 255	255 255 255 255	176 176 176 176 255 255 176 255 255 176
176 255 176 255 255 255 176 255 255 255 176 255 255 255 255 176 176 176 255 176
176 255 176 176 176 255 255 176 176 255 176 255 255 176 255 255 255 255 255 176
176 255 255 255 176 176 255 176 255 255 255 176 255 176 255 255 176 255 176 176	
176 255 176 255 255 176 176 176 255 255 255 255 255 176 255 255 176 255 255 176
176 255 255 255 255 255 255 255 176 255 176 255 176 176 176 176 176 176 255 176
176 176 176 176 176 176 176 255 255 255 255 255 255 176 255 255 255 176 255 176
176 255 255 176 255 255 176 176 176 255 255 176 255 176 255 255 255 176 255 176
176 255 176 176 255 255 255 255 176 255 255 255 255 255 255 255 255 176 255 176
176 255 176 176 255 176 255 255 176 176 176 176 255 255 255 255 255 176 255 176
176 255 255 176 255 255 176 255 255 255 255 255 255 176 176 176 176 176 255 176
176 255 255 255 255 176 176 255 176 255 255 255 255 255 176 176 255 255 255 176
176 176 176 176 255 176 255 255 255 176 176 176 176 255 176 176 255 176 176 176
176 255 255 255 255 255 255 176 255 255 255 255 176 255 255 255 255 176 255 176
255 255 176 176 176 176 255 255 176 255 176 255 176 176 176 176 255 255 255 176
176 255 255 176 255 176 176 176 176 255 176 176 255 255 255 255 255 255 176 176
176 255 255 255 255 255 255 255 255 255 255 255 176 255 255 176 255 255 255 255 
176 176 176 176 176 176 176 176 176 176 176 176 176 176 176 176 176 176 176 178 